....................
.V.V.V.V.V.V.V.V.V..
....................
.F..................
..........T.........
.....===R===........
.....########.......
...T................
....................
.......===R===.....X
.......########..####
..I.................
.####...............
.1..................
####################
