....................
.V.V.V.V.V.V.V.V.V..
..F.................
....................
..........T.........
.....===R===........
.....########.......
...T..............F.
....................
.......===R===.....X
.......########..####
..I.............T...
.####...............
.1..................
####################
